C	C
a	阿,啊
ai	爱,唉
ai ji	埃及
an	安
an jian	案件
an quan	安全
an zhao	按照
ba	巴,八,把,吧
ba li	巴黎
ba xi	巴西
bai	百
ban	办,半,班
ban dao	半岛
ban fa	办法
bang jia	绑架
bao	报
bao chi	保持
bao dao	报道
bao gao	报告
bao hu	保护
bao kuo	包括
bao yu	暴雨
bao zhang	保障
bei	被
bei bu	北部
bei jing	背景,北京
bei jing shi jian	北京时间
bei yue	北约
ben	本
ben ci	本次
ben yue	本月
bi	比
bi jiao	比较
bi ru	比如
bi xu	必须
bian hua	变化
biao da	表达
biao shi	表示
biao zhi	标志
biao zhun	标准
bie	别
bing	并
bing qie	并且
bo chu	播出
bu	不,部
bu duan	不断
bu fen	部分
bu guo	不过
bu hui	不会
bu jin	不仅
bu men	部门
bu neng	不能
bu shao	不少
bu shu	部署
bu tong	不同
bu yao	不要
bu zhang	部长
cai	采,才
cai fang	采访
cai qu	采取
can jia	参加
can yu	参与
ce	侧,策
ceng jing	曾经
chan pin	产品
chan sheng	产生
chan ye	产业
chang	场
chang qi	长期
chang yi	倡议
chao guo	超过
chao xian	朝鲜
che	车
cheng	乘,成,称,城
cheng gong	成功
cheng guo	成果
cheng li	成立
cheng nuo	承诺
cheng shi	城市
cheng wei	成为
chi	吃
chi xu	持续
chu	处,出
chu lai	出来
chu le	除了
chu li	处理
chu xi	出席
chu xian	出现
chuan tong	传统
chuang xin	创新
chun	春
ci	此,次
ci ci	此次
ci qian	此前
cong	从
cu jin	促进
cun zai	存在
cuo shi	措施
da	大,打
da cheng	达成
da dao	达到
da gai	大概
da hui	大会
da ji	打击
da jia	大家
da xing	大型
da xue	大学
da yu	大雨
da yue	大约
da zao	打造
dai	带,代
dai biao	代表
dai lai	带来
dan	但
dan shi	但是
dang	当,党
dang di	当地
dang qian	当前
dang shi	当时
dang tian	当天
dang zhong	当中
dao	岛,到
dao le	到了
dao zhi	导致
de	德,地,得,的
de dao	得到
de guo	德国
deng	等
deng deng	等等
di	第,低,迪
di da	抵达
di fang	地方
di qu	地区
di zhi	地址
dian	点,电
dian shi	电视
diao cha	调查
diao yan	调研
dong	东
dong bu	东部
dong fang	东方
dong li	动力
dong xi	东西
dou	都
dou shi	都是
du	度
duan	段,短
duan jiao	断交
dui	对
dui hua	对话
dui wai	对外
dui yu	对于
duo	多
duo ci	多次
duo nian	多年
e	呃,俄
e luo si	俄罗斯
er	尔,而,二
er ling yi qi	二零一七
er qie	而且
er shi	二十
er shi liu	二十六
er shi qi	二十七
er shi san	二十三
er shi si	二十四
er shi wu	二十五
er shi yi	二十一
er tong	儿童
er wei ma	二维码
fa	法,发
fa biao	发表
fa bu	发布
fa bu hui	发布会
fa chu	发出
fa guo	法国
fa hui	发挥
fa she	发射
fa sheng	发生
fa xian	发现
fa yan ren	发言人
fa yuan	法院
fa zhan	发展
fan	反
fan dui	反对
fan rong	繁荣
fan wei	范围
fan zui	犯罪
fang	方,放,访
fang an	方案
fang fan	防范
fang mian	方面
fang shi	方式
fang wen	访问
fang xiang	方向
fei	飞
fei chang	非常
fen	份,分
fen bie	分别
fen qi	分歧
fen zhong	分钟
fen zi	分子
feng hui	峰会
feng shuo	丰硕
feng xian	风险
fu	赴,福,夫
fu jian	福建
fu pin	扶贫
fu wu	服务
fu ze	负责
fu ze ren	负责人
gai	改,该
gai bian	改变
gai ge	改革
gai shan	改善
gan	感,干
gan jue	感觉
gan shou	感受
gan xie	感谢
gang	港
gang gang	刚刚
gao	高
gao du	高度
gao feng	高峰
gao ji	高级
gao wen	高温
gao xiao	高校
ge	个,各
ge de	各地
ge fang	各方
ge guo	各国
ge jie	各界
ge ren	个人
ge wei	各位
gei	给
gen	跟
gen ju	根据
geng	更
geng duo	更多
geng hao	更好
geng jia	更加
gong an	公安
gong bu	公布
gong cheng	工程
gong gong	公共
gong he guo	共和国
gong kai	公开
gong li	公里
gong min	公民
gong shi	共识
gong si	公司
gong tong	共同
gong xian	贡献
gong xiang	共享
gong ye	工业
gong you	共有
gong zuo	工作
gou tong	沟通
guan jian	关键
guan li	管理
guan xi	关系
guan xin	关心
guan yu	关于
guan zhong	观众
guan zhu	关注
guang dong	广东
guang fan	广泛
guang xi	广西
gui ding	规定
gui fan	规范
gui zhou	贵州
guo	国,过
guo cheng	过程
guo fang bu	国防部
guo ji	国际
guo jia	国家
guo lai	过来
guo min dang	国民党
guo nei	国内
guo qu	过去
guo wu yuan	国务院
ha	哈
hai	还,海
hai shang	海上
hai shi	还是
hai wai	海外
hai you	还有
hai zi	孩子
han	韩
han guo	韩国
hao	好,号
he	和,合,核
he bei	河北
he nan	河南
he ping	和平
he xin	核心
he zuo	合作
hen	很
hen duo	很多
hou	后
hu	户,互
hu bei	湖北
hu lian wang	互联网
hu nan	湖南
hu xin	互信
hua	华,化,话
hua bei	华北
hua ti	话题
huan jing	环境
huan ying	欢迎
huang	黄
hui	会,回
hui dao	回到
hui gui	回归
hui jian	会见
hui shang	会上
hui tan	会谈
hui wu	会晤
hui yi	会议
hui ying	回应
huo ban	伙伴
huo bi	货币
huo de	获得
huo dong	活动
huo li	活力
huo zai	火灾
huo zhe	或者
ji	级,基,及,既,暨,几,机
ji ben	基本
ji chang	机场
ji chu	基础
ji di	基地
ji duan	极端
ji gou	机构
ji guan	机关
ji hua	计划
ji ji	积极
ji jiang	即将
ji lu	记录
ji shi	及时
ji shu	技术
ji tuan	集团
ji xu	继续
ji yu	机遇
ji zhe	记者
ji zhi	机制
ji zhong	集中
jia	家,加
jia bin	嘉宾
jia ge	价格
jia qiang	加强
jian	建,件
jian chi	坚持
jian ding	坚定
jian guan	监管
jian jue	坚决
jian kang	健康
jian li	建立
jian she	建设
jiang	将,讲,江
jiang hua	讲话
jiang hui	将会
jiang su	江苏
jiang xi	江西
jiang yu	降雨
jiao	叫
jiao liu	交流
jiao tong	交通
jiao yu	教育
jie	界,届,节
jie duan	阶段
jie guo	结果
jie jue	解决
jie mu	节目
jie shao	介绍
jie shou	接受
jie shu	结束
jie xia lai	接下来
jie zhi	截止
jin	近,进
jin nian	今年
jin nian lai	近年来
jin qi	近期
jin ri	近日
jin rong	金融
jin ru	进入
jin tian	今天
jin xing	进行
jin yi bu	进一步
jin zhan	进展
jin zhuan	金砖
jing	经,京
jing fang	警方
jing guo	经过
jing ji	经济
jing shen	精神
jiu	九,就
jiu shi	就是
jiu shi shuo	就是说
ju	局,据
ju ban	举办
ju da	巨大
ju jiao	聚焦
ju li	距离
ju min	居民
ju shi	局势
ju ti	具体
ju xing	举行
ju you	具有
jue de	觉得
jue ding	决定
jun	军
jun fang	军方
jun shi	军事
ka	卡
ka ta er	卡塔尔
kai	开
kai fa	开发
kai fang	开放
kai mu	开幕
kai mu shi	开幕式
kai qi	开启
kai shi	开始
kai zhan	开展
kan	看
kan dao	看到
kan kan	看看
kao	靠
ke	可,科,克
ke hu duan	客户端
ke ji	科技
ke neng	可能
ke xue	科学
ke yi	可以
kong jian	空间
kong zhi	控制
kuai	快,块
la	拉
lai	来
lai shuo	来说
lai zi	来自
lan	兰
lang	朗
lao	老
le	了
lei	类,雷
li	力,利,李,丽,里
li ji	立即
li liang	力量
li mian	里面
li shi	历史
li yi	利益
li yong	利用
lian	连
lian bang	联邦
lian he	联合
lian he guo	联合国
lian xi	联系
lian xian	连线
lian xu	连续
liang	两,量,辆
liang an	两岸
liang hao	良好
liao jie	了解
lin	林
ling chen	凌晨
ling dao	领导
ling dao ren	领导人
ling wai	另外
ling yu	领域
liu	六
long	龙
lou	楼
lu	路
lu xu	陆续
lun	轮
lun tan	论坛
luo	罗
luo shi	落实
ma	嘛,吗,马
mao yi	贸易
mei	美,没,梅,每
mei guo	美国
mei nian	每年
mei ti	媒体
mei you	没有
men	们,门
meng	梦,蒙
meng xiang	梦想
mi	米
mi qie	密切
mi shu zhang	秘书长
mian dui	面对
mian lin	面临
min zhong	民众
ming	名,明
ming que	明确
ming tian	明天
ming xian	明显
mo	默
mu biao	目标
mu qian	目前
n	嗯
na	纳,那
na ge	那个
na me	那么
nan bu	南部
nan fang	南方
ne	呢
nei	内
nei rong	内容
neng	能
neng gou	能够
neng li	能力
neng yuan	能源
ni	你,尼
nian	年
nian qing	年轻
nin	您
nu li	努力
ou meng	欧盟
ou zhou	欧洲
peng you	朋友
pi	批
pian	片
pin dao	频道
ping jia	评价
ping tai	平台
pu bian	普遍
pu jing	普京
qi	起,其,期,奇,七
qi che	汽车
qi dai	期待
qi dong	启动
qi jian	期间
qi lai	起来
qi shi	七十,其实
qi ta	其他
qi wen	气温
qi ye	企业
qi zhong	其中
qian	钱,千,前
qian shu	签署
qiang	强
qiang diao	强调
qiang jiang yu	强降雨
qiang lie	强烈
qiao	桥
qing	清,请
qing kuang	情况
qing zhu	庆祝
qu	区,去
qu de	取得
qu nian	去年
qu xiao	取消
qu yu	区域
quan	全,权
quan bu	全部
quan guo	全国
quan mian	全面
quan qiu	全球
quan ti	全体
que	却
que bao	确保
que ding	确定
que ren	确认
ran hou	然后
rang	让
re	热
ren	人,任
ren he	任何
ren lei	人类
ren min	人民
ren min bi	人民币
ren shi	人士,认识
ren shu	人数
ren wei	认为
ren wu	任务
ren yuan	人员
reng ran	仍然
ri	日
ri ben	日本
ri qian	日前
rong he	融合
ru guo	如果
ru he	如何
san	三
san nian	三年
san shi	三十
san tian	三天
sao miao	扫描
sen	森
sha te	沙特
shan	山
shang	商,上
shang hai	上海
shang sheng	上升
shang wang	伤亡
shang wu	上午
shang ye	商业
shao	少
shao hou	稍后
she bei	设备
she hui	社会
she ji	涉及
she shi	设施
she xian	涉嫌
shen	深
shen fen	身份
shen hua	深化
shen me	什么
shen ru	深入
shen zhi	甚至
sheng	省
sheng chan	生产
sheng huo	生活
sheng ji	升级
sheng ming	声明,生命
shi	事,施,十,试,市,世,是,时,使,式
shi ba	十八
shi bu shi	是不是
shi chang	市场
shi dai	时代
shi er	十二
shi gu	事故
shi hou	时候
shi ji	世纪,实际
shi ji shang	实际上
shi jian	时间,事件,实践
shi jie	世界
shi jiu	十九
shi liu	十六
shi pin	视频
shi qi	十七
shi san	十三
shi shi	实施
shi si	十四
shi wei	市委
shi wu	十五,事务
shi xian	视线,实现
shi yan	试验,实验
shi ye	事业
shi yong	使用
shi zhong	始终
shou	受,首
shou ci	首次
shou dao	受到
shou du	首都
shou kan	收看
shou shang	受伤
shou xian	首先
shou xiang	首相
shu	数
shu ji	书记
shu ju	数据
shuang	双
shuang fang	双方
shui	水
shui ping	水平
shuo	说
shuo shi	说是
si	斯,四
si chuan	四川
si shi	四十
si wang	死亡
sou suo	搜索
sui	岁
sui zhe	随着
suo	所
suo wei	所谓
suo yi	所以
suo you	所有
suo zai	所在
ta	她,塔,他,它
ta men	他们
tai	太,台
tai wan	台湾
tan suo	探索
tao	套
tao lun	讨论
te	特
te bie	特别
ti	体
ti chu	提出
ti gao	提高
ti gong	提供
ti sheng	提升
ti shi	提示
ti xian	体现
ti zhi	体制
tian	天
tian qi	天气
tian ran qi	天然气
tiao	条
tiao jian	条件
tiao zhan	挑战
tiao zheng	调整
tie lu	铁路
ting	停,听
tong	通,同
tong bao	通报,同胞
tong guo	通过
tong ji	统计
tong shi	同时
tong yi	统一,同意
tou piao	投票
tou zi	投资
tu po	突破
tuan dui	团队
tuan jie	团结
tui chu	推出
tui dong	推动
tui jin	推进
wai	外
wai jiao	外交
wai jiao bu	外交部
wai zhang	外长
wan	万
wan cheng	完成
wan quan	完全
wan shang	晚上
wang	往,王,网
wang zhan	网站
wei	为,位,维
wei fa	违法
wei fan	违反
wei hu	维护
wei lai	未来
wei le	为了
wei sheng	卫生
wei xian	危险
wei xie	威胁
wei yu	位于
wei yuan	委员
wei yuan hui	委员会
wei zhi	位置
wen	文
wen ding	稳定
wen hua	文化
wen ming	文明
wen ti	问题
wo	我
wo guo	我国
wo men	我们
wu	无,五
wu ren ji	无人机
wu shi	五十
xi	息,西,习
xi bu	西部
xi huan	喜欢
xi ji	袭击
xi jin ping	习近平
xi lie	系列
xi tong	系统
xi wang	希望
xia	下
xia mian	下面
xia wu	下午
xia zai	下载
xian	县,线,先
xian chang	现场
xian jin	先进
xian sheng	先生
xian shi	显示
xian yi ren	嫌疑人
xian zai	现在
xiang	像,想,项,向
xiang gang	香港
xiang guan	相关
xiang mu	项目
xiang xi	详细
xiang xin	相信
xiao	消,小
xiao shi	小时
xiao xi	消息
xie shang	协商
xie tiao	协调
xie yi	协议
xin	新,心
xin wen	新闻
xin wen lian bo	新闻联播
xin xi	信息
xin xin	信心
xin xing	新型
xin yi lun	新一轮
xing	性,行,型
xing cheng	形成
xing dong	行动
xing shi	形势,形式
xing wei	行为
xing zheng	行政
xu li ya	叙利亚
xu yao	需要
xuan bu	宣布
xuan ju	选举
xuan ze	选择
xue	学
ya	呀,亚
yan fa	研发
yan ge	严格
yan jiu	研究
yan zhong	严重
yang shi	央视
yao	要
yao qing	邀请
yao qiu	要求
ye	夜,也
yi	一,伊,已,依,义,亿,以
yi ci	一次
yi dao	一道
yi dian	一点
yi ding	一定
yi dong	移动
yi fa	依法
yi ge	一个
yi hou	以后
yi hui	议会
yi ji	以及
yi jian	意见
yi jing	已经
yi kuai	一块
yi lai	以来
yi liao	医疗
yi lu	一路
yi qi	一起
yi qie	一切
yi shang	以上
yi shi	仪式,意识
yi si lan	伊斯兰
yi ti	议题
yi wai	意外
yi wei zhe	意味着
yi xi lie	一系列
yi xia	以下,一下
yi xie	一些
yi yang	一样
yi yi	意义
yi yuan	医院
yi zhi	一致,一直
yi zhong	一种
yin	寅,因
yin du	印度
yin fa	引发,印发
yin hang	银行
yin qi	引起
yin wei	因为
ying	应,莹,英
ying dui	应对
ying gai	应该
ying guo	英国
ying ji	应急
ying lai	迎来
ying xiang	影响
yong	用,勇
yong you	拥有
you	有,由,又
you de	有的
you guan	有关
you hao	友好
you qi	尤其
you shi	优势
you suo	有所
you xiao	有效
you yi	友谊
you yu	由于
yu	与,于
yu hui	与会
yu ji	预计
yu jing	预警
yu yi	予以
yuan	元,远,愿
yuan yi	愿意
yuan yin	原因
yuan ze	原则
yue	月,越,约
yue lai yue	越来越
yun ying	运营
zai	再,在
zai ci	再次
zai hai	灾害
zai jian	再见
zan men	咱们
zao	遭
zao cheng	造成
zao yu	遭遇
ze ren	责任
zen me	怎么
zen me yang	怎么样
zeng jia	增加
zhan	站
zhan kai	展开
zhan lve	战略
zhan shi	展示
zhan zai	站在
zhang	张,长
zhao dao	找到
zhao kai	召开
zhe	者,这,着
zhe ge	这个
zhe jiang	浙江
zhe li	这里
zhe me	这么
zhe ming	著名
zhe yang	这样
zhe zhong	这种
zhei xie	这些
zhen de	真的
zhen dui	针对
zhen zheng	真正
zheng	正,证
zheng ce	政策
zheng chang	正常
zheng fu	政府
zheng ge	整个
zheng shi	正式
zheng zai	正在
zheng zhi	整治,政治
zhi	至,只,之,支,志
zhi bo	直播
zhi chi	支持
zhi chu	指出
zhi dao	指导,知道
zhi du	制度
zhi hou	之后
zhi jian	之间
zhi jie	直接
zhi neng	智能
zhi qian	之前
zhi shao	至少
zhi shi	只是
zhi wai	之外
zhi xia	之下
zhi xing	执行
zhi you	只有
zhi zao	制造
zhong	重,种,中,钟
zhong bu	中部
zhong da	重大
zhong dian	重点
zhong e	中俄
zhong fang	中方
zhong gong zhong yang	中共中央
zhong gong zhong yang zheng zhi ju	中共中央政治局
zhong guo	中国
zhong hua min zu	中华民族
zhong shi	重视
zhong wu	中午
zhong xin	中心
zhong yang	中央
zhong yang qi xiang tai	中央气象台
zhong yao	重要
zhou	周
zhou nian	周年
zhu	住,驻
zhu he	祝贺
zhu quan	主权
zhu ti	主体,主题
zhu xi	主席
zhu yao	主要
zhu yi	主义,注意
zhua	抓
zhuan	转
zhuan ji	专机
zhuan jia	专家
zhuan xiang	专项,转向
zhuan ye	专业
zhuang tai	状态
zhun bei	准备
zi	自
zi ben	资本
zi ji	自己
zi jin	资金
zi xun	资讯
zi you	自由
zi yuan	资源
zi zhu	自主
zong	总
zong he	综合
zong li	总理
zong shu ji	总书记
zong tong	总统
zou	走
zu	组
zu guo	祖国
zu zhi	组织
zui	最
zui gao	最高
zui hou	最后
zui jin	最近
zui xin	最新
zui zhong	最终
zun zhong	尊重
zuo	座,做,作
zuo chu	做出,作出
zuo dao	做到
zuo hao	做好
zuo tian	昨天
zuo wei	作为
zuo yong	作用
zuo you	左右
